1111111111111
10C10000000E1
1000011C11001
1P00111100001
1111111111111